11111111111111111111111111
100C00000C00000000000000E1
11111011111111111111111111
101C100000C00000000C000101
10101011111111111111111101
10001000000000000000000001
101111111111111C1111111101
1010C000000000000000C00001
10101111111111101111111111
101010C0000000000000000101
10101011111111111111111101
101010000000000000000C0001
10101011111111111111111001
10101000000000000000000001
101111111111111C1111111101
10000000000010000000000001
10001000100010001000100001
10111011110111011110111001
10100010000000000010000001
10101111101111111111111001
1010C010000010000010000001
10111111110111011110111001
10C010000000000000C01000P1
11111111111111111111111111
