111111111111111111111111
100C000000C0000000001E11
111110111111111111111111
1010100000C000000000C001
1C1010111111111111111111
101000000000000000000101
10111111111110C111111101
1010C000000000000000C101
10101111111111C111111101
101010C00000000000000101
10101011111110C111111101
10101C000000000000000C01
101010111111111111111101
101000000000000000000101
10111111111111C111111101
1000000000000000000000P1
111111111111111111111111